Evol Intent - South London
Yeasayer - Rome
Noprofit and Vipercorps - Bassline
The Prodigy - Stand Up
Beck - E-Pro?
Brookes Brothers
Reden - Game Over

Nujabes - Yes
Mad Doctor X - Real Heavy Science
PSO - Image of Hero
She - Lain's toy musicbox

Flying Lotus - Promiscuous
Lil Ugly Mane - Twistin

Son House - John the Revelator
Depeche Mode - John the Revelaton
E-40-_Function_Feat._YG,_IamSu_&_Problem

1/17/2023
Dam Funk - Burn Rubber (Dam Funk Remix) (Hip hop, funky)
Blank Blue (Flying Lotus Instrumental) (Chill, downtempo, funky)
Flying Lotus - Sangria Spin Cycles (Downtempo, Funky, Adult Swim bump)
Fulgeance - Chico (Dorian Concept Remix) (Wonky, Funky, 110PBM)
Lost - Flying Lotus Rework (Wonky, Funky, Downtempo, I got to make you cum)
Radiohead - Reckoner (Flying Lotus Remix) (Chill, Funky, Wonky)
Robot Death Squad - Space Cowboy (D-Struct 2007 VIP) (Dark, Techy)
Teebee - Padawan (Techy, Neurofunk, Downtempo)
Twenty One Pilots - Heathens (Magnetude Bootleg) (Techy, Heavy, Neurofunk)
FLYamSAM - Princess Toadstool (Chill, hip hop, downtempo, Los Angeles-sounding)
Flying Lotus - Cackle (Extended) (Chill, Hip hop, downtempo)
Flying Lotus - Pet Monster Shotglass (Chill, hip hop, downtempo)
Geoff Barrow - G.B. Beats (Portishead Radio Edit) (Chill, hip hop, downtempo, portishead)
Joker - Solid State (Jumpy, Hip hop, Chill)
Low Limit - Turf Day (Hip Hop, Chill, downtempo)
Manzel - Midnight Theme (Chill, downtempo, funky, hip hop)
Mike Slott - Home (Chill, downtempo, funky, hip hop)
Mono_Poly - Needsdeodorantbitch (Uptempo, funky, hip hop)
Muhsinah+ Flying Lotus - With Me _ Melt (Hip hop, wonky, funky, India vocal)
P.U.D.G.E - Yung Infamous (Hip hop, wonky)
Rusko - Moaners (Hard, dupstep, hip hop)
Samiyam- Flintstone Car (Chill, downtempo, hip hop)
Samiyam - Falafel Cannon (Chill, downtempo, hip hop)
Sa-Ra - _Hollywood_ music video (Chill, hip hop, downtempo, Los Angeles-sounding, hollywood hollywood)
