Daft Punk - One More Time:
  Eddie Johns - More Spell On You

Daft Punk - Aerodynamic:
  Sister Sledge - Il Macquillage Lady

Daft Punk - Digital Love: 
  George Duke - I Love You More

Daft Punk - Harder Better Faster Stronger: 
  Edwin Birdsong - Cola Bottle Baby
  Vitamin String Quarter - Harder, Better, Faster, Stronger
  Kanye West - Stronger

Future - Mask Off:
Tommy Butler - Prison Song

Travis Scott - Sicko Mode:
  Luke - I wanna rock
  Notorious BIG - Gimme the Loot:
    James Brown - Coldblooded
    Ohio Players - Singing in the Morning
    Gang Starr - Just to Get a Rep
    A Tribe Called Quest - Scenario (Remix)
    Onyx - Throw Ya Gunz
    Boyz II Men - It's So Hard to Say Goodbyte to Yesterday
    Ice Cube - What they hittin' foe:
      Average White Band - The Jugglers
      Stanley Turretine - Sister Sanctified
      Melvin Bliss - Syntehtic Substitution
      The Cecil Holmes Soulful Sounds - 2001
      Juice - Catch a Groove

The Game - Celebration: 
  Bone Thugs-N-Harmony - 1st of Tha Month:
    Marvin Gaye - Sexual Healing
    Chapter 8 - I Just Wanna Be Your Girl

Kendrick Lamar - Hood Politics:
  Sufjan Stevens - All For mYself
  Jay-Z - Imaginary Player
  Notorious BIG and Bone Thugs-N-Harmony - Notorious Thugs:
    Wu-Tang Clan - C.R.E.A.M.:
      The Charmels - As Long as I've Got You
      Jimmy Spicer - Money (Dollar Bill Y'all)
      The Delfonics - Hey Love
